~~~~~~~~~~~~~~~~~~~~~~~~~~~~~~~~~~~~~~~~~~~~~~~~
~~~~~~~~~~~~~~~~~~~~~~~~~~~~~~~~~~~~~~~~~~~~~~~~
~~~~~~~~~~**F*****~~~~~~~~~~~~~~~~~~~~~*~~~~~~~~
~~~~~~*****FF*FF********~*~~~~~~~~~~~****~~~~~~~
~~~~*FFFF****FFF*x*~****~****~~~~~~~******~~~~~~
~~*FFFF*FF*FFFFFFxxx*FFF**~~~~~~~~~~**********~~
~~~FFF******FFFFFF*x****FFFFFF*~~~~************~
~~~~*FF***F*FFFFFFFx******FFFF**~~~***********~~
~~~~~FF***F****FFF*xxxxxx****FF***~***********~~
~~~~~**FFF**FF**FFFxFFFFxx*FFFF***~************~
~~~~~~~**FFF*F***FFx*FFFFxxxxxxxx*B*x*********~~
~~~~~~~****FFFF*FFxxFF*FFFF****FF*~*x*********~~
~~~~~~**FFFFFF****x**FFFFF******F*~*x*********~~
~~~******FFFFFFFFFx*FFFFFFFF**FF*~~*x**********~
~~~~~*****FFFFFFFFx****FFF***FF*~~**x**********~
~~~~~******FFFFFxxx*FFFF*****F*~~***x**********~
~~~~~~***FFFFF*xx*FFFF***~~~~~~~***xx**********~
~~~~~~****FF***x********~~********xxxxx********~
~~~~~~~*****xxxx*FFFF***~*******xx****xx*******~
~~~~~~~~~***xF*xxFFF***~~*****xxx******xx******~
~~~~~~~~~~*FxFF*xxxxx**~***xxxx*******+*xx*****~
~~~~~~~~**Fxx*FF**FFx*~~***x****++***+++*x*****~
~~~~~~~*F*xxFFF**FFFx*~****x**+++++++++++x*****~
~~~~~~*FF*xFFFF***FFx*B*xxxx**+++-----+++x*****~
~~~~~~FFF*xFFFF****FF*~**x*****++++--+++*x*****~
~~~~~~FFF*x*FFFF****F*~**x*******+++-++**x*****~
~~~~~~~FFFx***FFF*****~**x**+++++++--+++*x*****~
~~~~~~FFFFxx*FFF*****~~**xxx**+++---+++**x*****~
~~~~~~~FF**x*FF****~~~~****x*++++++++++**x*****~
~~~~~~~~*F*x**FFF*~~~~~~~~*x**++++++++++*xxxx**~
~~~~~~~*F**xx****~~~~~~***xx**++++++++++****x**~
~~~~~~***HHHx*HH***~~~**FFxFF**++++++++++++*x**~
~~~~~****HHHx*HH*F**~***FFxFF***++++++++**xxx**~
~~~~~*FF*xxxxxxx*FF*~***FFxxxFF**+++++++FFx****~
~~~~~*F****x*****FF*~****FFFxxFF*F++++FFxxx****~
~~~~~~**HH*x*HHH*FF*~~****FFFxxFF*F++FFFx******~
~~~~~~~*HH*x*HHH*FFF*~~***FFFFxFFFFF+FFFx******~
~~~*~~~~*xxxxxxxxxxxx*B*xxxxxxxxxxxxFFFFx******~
~~~**~~~~*FFFFx*FF*F**~***FFFxxFFFFxxxxxx******~
~~*F****~*FF**x*****~~~~~~**xxFF**FFFFFFFF*****~
~**FF***B**FFFx*****~~*~~~*FxFF*****FFFF*******~
~~*FFF**~*FFF*x*****~~***~*FxFF****************~
~~~*F*~~~*FFFFxx***~~~***B*xxFF****************~
~~~~*~~~~*FFF**x***~***F*~*FFFF****************~
~~~~~~~~~~*F*FFxxx*B***FF*~~~******************~
~~~~~~~~*FFFF******~**FFFF*~~~~****************~
~~~~~~*********~~~~~~~****~~~~~~***~~~*~~~~****~
~~~~~~~~~~~~~~~~~~~~~~~~~~~~~~~~~~~~~~~~~~~~~~~~
