~~~~~~~~~~~~~~~~~~~~~~~~~~~~~~~~~~~~~~~~~~~~~~~~
~~~~~~~~~~~~~~~~~~~~~~~~~~~~~~~~~~~~~~~~~~~~~~~~
~~~~~~~~~~**F*****~~~~~~~~~~~~~~~~~~~~~*~~~~~~~~
~~~~~~*****FF*FF********~*~~~~~~~~~~~****~~~~~~~
~~~~*FFFF****FFF***~****~****~~~~~~~******~~~~~~
~~*FFFF*FF*FFFFFF****FFF**~~~~~~~~~~**********~~
~~~FFF******FFFFFF******FFFFFF*~~~~************~
~~~~*FF***F*FFFFFFF*******FFFF**~~~***********~~
~~~~~FF***F****FFF***********FF***~***********~~
~~~~~**FFF**FF**FFFFFFFF***FFFF***~************~
~~~~~~~**FFF*F***FF**FFFFFFF******B***********~~
~~~~~~~****FFFF*FF**FF*FFFF****FF*~***********~~
~~~~~~**FFFFFF*******FFFFF******F*~***********~~
~~~******FFFFFFFFF**FFFFFFFF**FF*~~************~
~~~~~*****FFFFFFFF*****FFF***FF*~~*************~
~~~~~******FFFFF****FFFF*****F*~~**************~
~~~~~~***FFFFF****FFFF***~~~~~~~***************~
~~~~~~****FF************~~*********************~
~~~~~~~**********FFFF***~**********************~
~~~~~~~~~***FF***FFF***~~**********************~
~~~~~~~~~~*F*FF***FF***~**************+********~
~~~~~~~~**F***FF**FF**~~********++***+++*******~
~~~~~~~*F***FFF**FFF**~*******+++++++++++******~
~~~~~~*FF**FFFF***FF**B*******+++-----++++*****~
~~~~~~FFF**FFFF****FF*~********++++--+++*******~
~~~~~~FFF***FFFF****F*~**********+++-++********~
~~~~~~~FFF****FFF*****~*****+++++++--+++*******~
~~~~~~FFFF***FFF*****~~*******+++---+++********~
~~~~~~~FF****FF****~~~~******++++++++++********~
~~~~~~~~**********~~~~~~~~****++++++++++*******~
~~~~~~~**********~~~~~~*******++++++++++*******~
~~~~~~***HHH**HH***~~~*********++++++++++++****~
~~~~~****HHH**HH****~***********++++++++*******~
~~~~~**HH***********~************+++++++*******~
~~~~~**HH**hhh***HH*~*************++++*********~
~~~~~~*****hhh***HH*~~*************++**********~
~~~~~~~**************~~*************+**********~
~~~*~~~~*******HH*****B************************~
~~~**~~~~******HH*****~************************~
~~***~~~~******HH***~~~~***********************~
~*******~~**********~~*~~**********************~
~~*****~~~**********~~**~~*********************~
~~~***~~~**********~~~***~~********************~
~~~~*~~~~********~~~~*****~~*******************~
~~~~~~~~~~***~~~~~~~~******~~******************~
~~~~~~~~******~~~~~~*******~~~~****************~
~~~~~~*********~~~~~~~****~~~~~~***~~~*~~~~****~
~~~~~~~~~~~~~~~~~~~~~~~~~~~~~~~~~~~~~~~~~~~~~~~~
