~~~~~~~~~~~~~~~~~~~~~~~~~~~~~~~~~~~~~~~~~~~~~~~~
~~~~~~~~~~~~~~~~~~~~~~~~~~~~~~~~~~~~~~~~~~~~~~~~
~~~~~~~~~~********~~~~~~~~~~~~~~~~~~~~~*~~~~~~~~
~~~~~~******************~*~~~~~~~~~~~****~~~~~~~
~~~~***************~****~****~~~~~~~******~~~~~~
~~************************~~~~~~~~~~**********~~
~~~****************************~~~~************~
~~~~****************************~~~***********~~
~~~~~*****************************~***********~~
~~~~~*****************************~************~
~~~~~~~***************************~***********~~
~~~~~~~***************************~***********~~
~~~~~~****************************~***********~~
~~~******************************~~************~
~~~~~***************************~~*************~
~~~~~**************************~~**************~
~~~~~~*******************~~~~~~~***************~
~~~~~~******************~~*********************~
~~~~~~~*****************~**********************~
~~~~~~~~~**************~~**********************~
~~~~~~~~~~*************~***********************~
~~~~~~~~**************~~***********************~
~~~~~~~***************~************************~
~~~~~~****************~************************~
~~~~~~****************~************************~
~~~~~~****************~************************~
~~~~~~~***************~************************~
~~~~~~***************~~************************~
~~~~~~~************~~~~************************~
~~~~~~~~**********~~~~~~~~*********************~
~~~~~~~**********~~~~~~************************~
~~~~~~*************~~~*************************~
~~~~~***************~**************************~
~~~~~***************~**************************~
~~~~~***************~**************************~
~~~~~~**************~~*************************~
~~~~~~~**************~~************************~
~~~*~~~~**************~************************~
~~~**~~~~*************~************************~
~~***~~~~***********~~~~***********************~
~*******~~**********~~*~~**********************~
~~*****~~~**********~~**~~*********************~
~~~***~~~**********~~~***~~********************~
~~~~*~~~~********~~~~*****~~*******************~
~~~~~~~~~~***~~~~~~~~******~~******************~
~~~~~~~~******~~~~~~*******~~~~****************~
~~~~~~*********~~~~~~~****~~~~~~***~~~*~~~~****~
~~~~~~~~~~~~~~~~~~~~~~~~~~~~~~~~~~~~~~~~~~~~~~~~
