~~~~~~~~~~~~~~~~~~~~~~~~~~~~~~~~~~~~~~~~~~~~~~~~
~~~~~~~~~~~~~~~~~~~~~~~~~~~~~~~~~~~~~~~~~~~~~~~~
~~~~~~~~~~********~~~~~~~~~~~~~~~~~~~~~*~~~~~~~~
~~~~~~******************~*~~~~~~~~~~~****~~~~~~~
~~~~***************~****~****~~~~~~~******~~~~~~
~~************************~~~~~~~~~~**********~~
~~~****************************~~~~************~
~~~~****************************~~~***********~~
~~~~~*****************************~***********~~
~~~~~*****************************~************~
~~~~~~~***************************B***********~~
~~~~~~~***************************~***********~~
~~~~~~****************************~***********~~
~~~******************************~~************~
~~~~~***************************~~*************~
~~~~~**************************~~**************~
~~~~~~*******************~~~~~~~***************~
~~~~~~******************~~*********************~
~~~~~~~*****************~**********************~
~~~~~~~~~**************~~**********************~
~~~~~~~~~~*************~**************+********~
~~~~~~~~**************~~********++***+++*******~
~~~~~~~***************~*******+++++++++++******~
~~~~~~****************B*******+++-----++++*****~
~~~~~~****************~********++++--+++*******~
~~~~~~****************~**********+++-++********~
~~~~~~~***************~*****+++++++--+++*******~
~~~~~~***************~~*******+++---+++********~
~~~~~~~************~~~~******++++++++++********~
~~~~~~~~**********~~~~~~~~****++++++++++*******~
~~~~~~~**********~~~~~~*******++++++++++*******~
~~~~~~*************~~~*********++++++++++++****~
~~~~~***************~***********++++++++*******~
~~~~~***************~************+++++++*******~
~~~~~***************~*************++++*********~
~~~~~~**************~~*************++**********~
~~~~~~~**************~~*************+**********~
~~~*~~~~**************B************************~
~~~**~~~~*************~************************~
~~***~~~~***********~~~~***********************~
~*******~~**********~~*~~**********************~
~~*****~~~**********~~**~~*********************~
~~~***~~~**********~~~***~~********************~
~~~~*~~~~********~~~~*****~~*******************~
~~~~~~~~~~***~~~~~~~~******~~******************~
~~~~~~~~******~~~~~~*******~~~~****************~
~~~~~~*********~~~~~~~****~~~~~~***~~~*~~~~****~
~~~~~~~~~~~~~~~~~~~~~~~~~~~~~~~~~~~~~~~~~~~~~~~~
