~~~~~~~~~~~~~~~~~~~~~~~~~~~~~~~~~~~~~~~~~~~~~~~~
~~~~~~~~~~~~~~~~~~~~~~~~~~~~~~~~~~~~~~~~~~~~~~~~
~~~~~~~~~~**F*****~~~~~~~~~~~~~~~~~~~~~*~~~~~~~~
~~~~~~*****FF*FF********~*~~~~~~~~~~~****~~~~~~~
~~~~*FFFF****FFF***~****~****~~~~~~~******~~~~~~
~~*FFFF*FF*FFFFFF****FFF**~~~~~~~~~~**********~~
~~~FFF******FFFFFF******FFFFFF*~~~~************~
~~~~*FF***F*FFFFFFF*******FFFF**~~~***********~~
~~~~~FF***F****FFF***********FF***~***********~~
~~~~~**FFF**FF**FFFFFFFF***FFFF***~************~
~~~~~~~**FFF*F***FF**FFFFFFF******B***********~~
~~~~~~~****FFFF*FF**FF*FFFF****FF*~***********~~
~~~~~~**FFFFFF*******FFFFF******F*~***********~~
~~~******FFFFFFFFF**FFFFFFFF**FF*~~************~
~~~~~*****FFFFFFFF*****FFF***FF*~~*************~
~~~~~******FFFFF****FFFF*****F*~~**************~
~~~~~~***FFFFF****FFFF***~~~~~~~***************~
~~~~~~****FF************~~*********************~
~~~~~~~**********FFFF***~**********************~
~~~~~~~~~***FF***FFF***~~**********************~
~~~~~~~~~~*F*FF***FF***~**************+********~
~~~~~~~~**F***FF**FF**~~********++***+++*******~
~~~~~~~*F***FFF**FFF**~*******+++++++++++******~
~~~~~~*FF**FFFF***FF**B*******+++-----++++*****~
~~~~~~FFF**FFFF****FF*~********++++--+++*******~
~~~~~~FFF***FFFF****F*~**********+++-++********~
~~~~~~~FFF****FFF*****~*****+++++++--+++*******~
~~~~~~FFFF***FFF*****~~*******+++---+++********~
~~~~~~~FF****FF****~~~~******++++++++++********~
~~~~~~~~*F****FFF*~~~~~~~~****++++++++++*******~
~~~~~~~*F********~~~~~~*******++++++++++*******~
~~~~~~***HHH**HH***~~~*********++++++++++++****~
~~~~~****HHH**HH*F**~***********++++++++*******~
~~~~~*FF*********FF*~************+++++++*******~
~~~~~*F**********FF*~*************++++*********~
~~~~~~**HH***HHH*FF*~~*************++**********~
~~~~~~~*HH***HHH*FFF*~~*************+**********~
~~~*~~~~**************B************************~
~~~**~~~~*FFFF**FF*F**~************************~
~~*F*~~~~*FF********~~~~***********************~
~**FF***~~*FFF******~~*~~**********************~
~~*FFF*~~~FFF*******~~**~~*********************~
~~~*F*~~~*FFFF*****~~~*F*~~********************~
~~~~*~~~~*FFF****~~~~**F**~~*******************~
~~~~~~~~~~*F*~~~~~~~~**FF**~~******************~
~~~~~~~~*FFFF*~~~~~~**FFFF*~~~~****************~
~~~~~~*********~~~~~~~****~~~~~~***~~~*~~~~****~
~~~~~~~~~~~~~~~~~~~~~~~~~~~~~~~~~~~~~~~~~~~~~~~~
