~~~~~~~~~~~~~~~~~~~~~~~~~~~~~~~~~~~~~~~~~~~~~~~~
~~~~~~~~~~~~~~~~~~~~~~~~~~~~~~~~~~~~~~~~~~~~~~~~
~~~~~~~~~~********~~~~~~~~~~~~~~~~~~~~~~~~~~~~~~
~~~~~~********************~~~~~~~~~~~****~~~~~~~
~~~~************************~~~~~~~~******~~~~~~
~~~***************************~~~~~~**********~~
~~~****************************~~~~************~
~~~~****************************~~~************~
~~~~~*****************************~************~
~~~~~*****************************~************~
~~~~~~~***************************~************~
~~~~~~~***************************~************~
~~~~~~****************************~************~
~~~~*****************************~~************~
~~~~~***************************~~*************~
~~~~~**************************~~**************~
~~~~~~*******************~~~~~~~***************~
~~~~~~******************~~*********************~
~~~~~~~*****************~**********************~
~~~~~~~~~**************~~**********************~
~~~~~~~~~~*************~***********************~
~~~~~~~~**************~~***********************~
~~~~~~~***************~************************~
~~~~~~****************~************************~
~~~~~~****************~************************~
~~~~~~****************~************************~
~~~~~~~***************~************************~
~~~~~~***************~~************************~
~~~~~~~************~~~~************************~
~~~~~~~~**********~~~~~~~~*********************~
~~~~~~~**********~~~~~~************************~
~~~~~~*************~~~*************************~
~~~~~***************~**************************~
~~~~~***************~**************************~
~~~~~***************~**************************~
~~~~~~**************~~*************************~
~~~~~~~**************~~************************~
~~~~~~~~**************~************************~
~~~~~~~~~*************~************************~
~~~~~~~~~*************~~***********************~
~~~~~~~~~~*************~~**********************~
~~~~~~~~~~**************~~*********************~
~~~~~~~~~****************~~********************~
~~~~~~~~~*****************~~*******************~
~~~~~~~~~~*****************~~******************~
~~~~~~~~*******************~~~~****************~
~~~~~~**********************~~~~***************~
~~~~~~~~~~~~~~~~~~~~~~~~~~~~~~~~~~~~~~~~~~~~~~~~
