~~~~~~~~~~~~~~~~~~~~~~~~~~~~~~~~~~~~~~~~~~~~~~~~
~~~~~~~~~~~~~~~~~~~~~~~~~~~~~~~~~~~~~~~~~~~~~~~~
~~~~~~~~~~**F*****~~~~~~~~~~~~~~~~~~~~~*~~~~~~~~
~~~~~~*****FF*FF********~*~~~~~~~~~~~****~~~~~~~
~~~~*FFFF****FFF*x*~****~****~~~~~~~******~~~~~~
~~*FFFF*FF*FFFFFFxxx*FFF**~~~~~~~~~~**********~~
~~~FFF******FFFFFF*x****FFFFFF*~~~~************~
~~~~*FF***F*FFFFFFFx******FFFF**~~~***********~~
~~~~~FF***F****FFF*xxxxxx****FF***~***********~~
~~~~~**FFF**FF**FFFxFFFFxx*FFFF***~************~
~~~~~~~**FFF*F***FFx*FFFFxxxxxxxx*B***********~~
~~~~~~~****FFFF*FFxxFF*FFFF****FF*~***********~~
~~~~~~**FFFFFF****x**FFFFF******F*~***********~~
~~~******FFFFFFFFFx*FFFFFFFF**FF*~~************~
~~~~~*****FFFFFFFFx****FFF***FF*~~*************~
~~~~~******FFFFFxxx*FFFF*****F*~~**************~
~~~~~~***FFFFF*xx*FFFF***~~~~~~~***************~
~~~~~~****FF***x********~~*********************~
~~~~~~~*****xxxx*FFFF***~**********************~
~~~~~~~~~***xF*xxFFF***~~**********************~
~~~~~~~~~~*FxFF*xxxxx**~**************+********~
~~~~~~~~**Fxx*FF**FFx*~~********++***+++*******~
~~~~~~~*F*xxFFF**FFFx*~*******+++++++++++******~
~~~~~~*FF*xFFFF***FFx*B*******+++-----++++*****~
~~~~~~FFF*xFFFF****FF*~********++++--+++*******~
~~~~~~FFF*x*FFFF****F*~**********+++-++********~
~~~~~~~FFFx***FFF*****~*****+++++++--+++*******~
~~~~~~FFFFxx*FFF*****~~*******+++---+++********~
~~~~~~~FF**x*FF****~~~~******++++++++++********~
~~~~~~~~*F*x**FFF*~~~~~~~~****++++++++++*******~
~~~~~~~*F**xx****~~~~~~*******++++++++++*******~
~~~~~~***HHHx*HH***~~~*********++++++++++++****~
~~~~~****HHHx*HH*F**~***********++++++++*******~
~~~~~*FF*xxxxxxx*FF*~************+++++++*******~
~~~~~*F****x*****FF*~*************++++*********~
~~~~~~**HH*x*HHH*FF*~~*************++**********~
~~~~~~~*HH*x*HHH*FFF*~~*************+**********~
~~~*~~~~*xxxxxxxxxxxxxB************************~
~~~**~~~~*FFFF**FF*F**~************************~
~~*F*~~~~*FF********~~~~***********************~
~**FF***~~*FFF******~~*~~**********************~
~~*FFF*~~~FFF*******~~**~~*********************~
~~~*F*~~~*FFFF*****~~~*F*~~********************~
~~~~*~~~~*FFF****~~~~**F**~~*******************~
~~~~~~~~~~*F*~~~~~~~~**FF**~~******************~
~~~~~~~~*FFFF*~~~~~~**FFFF*~~~~****************~
~~~~~~*********~~~~~~~****~~~~~~***~~~*~~~~****~
~~~~~~~~~~~~~~~~~~~~~~~~~~~~~~~~~~~~~~~~~~~~~~~~
